F 76,76,76
C 99,99,99

NO textures/portal_wall_no.xpm
SO textures/portal_wall_so.xpm
WE textures/portal_wall_we.xpm
EA textures/portal_wall_ea.xpm

11111111111111111111111111111111111111111111111111
10001000001000000000101000000000000000000000000011
11101011101011111110101011111111111111111011111011
10001010101000000010001000000000100000000010001011
10111010101011111011101111111110101111111110111011
10100010101000001010000010001000100010000010000011
10101110101111101011111110101011111010101110111111
10001010001000101000000000100010000010101000100011
11111010111011101111111111111110111110101011111011
10100010001000101000100000100010000010101000001011
10101011101110101010111110101011111011101111101011
10001000101000100010100010001000001000100000101011
10111110101011111110101010111011101110111011101011
10100010001000000000101010001010001010001000100011
10101111111011111111101011111010111011101110111011
10100010001010000000101010000010000000100010000011
10101010101010111110101010111111111111111011101111
10101000100000100000001000100000000000001000100011
10111011111111101111111111101111111111101110111011
10001000100000100010100000100000100010001000100011
11101011101110111010101110111110101110111011111011
10101010001000100000101000100000100010101000001011
10101110111011101111101011101111101010101011101111
10100000101010100010001000001000101000100000100011
10111111101010101110101111111110101111111111111011
10001000000010001000101000000010100000001000100011
10101011111110111011111011111010111111101010101011
10100010001000100010000010000010000000100010101011
10111110101011101010111110111111101111111110101111
1000100010100010101010001000000010000000N000100011
11101111101110101010101111101110111011111111111011
10100000100010101010001000100010001000100000000011
10111110101010101111101010111111101110101111101111
10001000101000100000001010000000101000100000100011
10101011101111111111111011111110101011111110111011
10101010000000100000001000000010001000001000101011
10101011111110101010111111111011111111101110101011
10101000001000101010100000001000000010100010001011
10101111101110101011101111101111111010111011111011
10100000100010101000001000100000100010001000001011
10111010111010111111111010101110101110101111101011
10100010001010001000100010001000100010100000101011
10101111111011101010101111111011111011111110101011
10101000100010000010101010000000001000001000101011
10101010101111111110101010111111111110101011101011
10100010100010001000001000100000000010101000001011
10111110111010101111111111101111111011101011111011
10000010000000100000000000001000000000001000000011
11111111111111111111111111111111111111111111111111