NO textures/no.xpm
SO textures/so.xpm
WE textures/we.xpm
EA textures/ea.xpm

F 44,70,0
C 20,20,20

1111111111
1001011111
1000000001
1100N00001
1000000001
1111111111