NO textures/wolfenstein/purple_stone.xpm
SO textures/wolfenstein/red_brick.xpm
WE textures/wolfenstein/grey_stone.xpm
EA textures/wolfenstein/wood.xpm

F 17,38,64
C 218,234,235

111111
102301
100001
100001
111111
